setGlobalVariable = setGlobalVariable
getSlider = getSlider
getPropertyDouble = getPropertyDouble
getProperty = getProperty
sendMidiMessageNow = sendMidiMessageNow
getPanelEditor = getPanelEditor
getProgramState = getProgramState
getToggleButtonComponent = getToggleButtonComponent
getObjectTree = getObjectTree
setProgramState = setProgramState
getModulator = getModulator
getCanvas = getCanvas
setPropertyString = setPropertyString
getLabel = getLabel
setRestoreState = setRestoreState
getFixedSlider = getFixedSlider
setPropertyColour = setPropertyColour
getPropertyString = getPropertyString
getGlobalVariable = getGlobalVariable
getWaveformComponent = getWaveformComponent
getComboComponent = getComboComponent
removeProperty = removeProperty
setPropertyInt = setPropertyInt
getCombo = getCombo
getLabelComponent = getLabelComponent
getLCDLabelComponent = getLCDLabelComponent
getRestoreState = getRestoreState
getModulatorByIndex = getModulatorByIndex
getWaveform = getWaveform
getCtrlrMIDILibrary = getCtrlrMIDILibrary
getImageSliderComponent = getImageSliderComponent
getModulatorsWithProperty = getModulatorsWithProperty
getFileListBox = getFileListBox
getListBox = getListBox
getFileListBoxComponent = getFileListBoxComponent
getImageButtonComponent = getImageButtonComponent
getFixedImageSlider = getFixedImageSlider
getToggleButton = getToggleButton
getComponent = getComponent
getBootstrapState = getBootstrapState
getSliderComponent = getSliderComponent
getImageButton = getImageButton
getPropertyInt = getPropertyInt
getModulatorWithProperty = getModulatorWithProperty
dumpDebugData = dumpDebugData
getModulatorByName = getModulatorByName
getModulatorsWildcard = getModulatorsWildcard
getFixedImageSliderComponent = getFixedImageSliderComponent
setModulatorValuesFromData = setModulatorValuesFromData
getNumModulators = getNumModulators
getListBoxComponent = getListBoxComponent
getFixedSliderComponent = getFixedSliderComponent
getModulatorValuesAsData = getModulatorValuesAsData
setPropertyDouble = setPropertyDouble
getLCDLabel = getLCDLabel
getButton = getButton
setProperty = setProperty
getInputComparator = getInputComparator
getImageSlider = getImageSlider
getButtonComponent = getButtonComponent
sendMidi = sendMidi
isRestoring = isRestoring